state_code_clusters,zip_cluster,city_clusters,startup_age_in_years,funding_rounds,age_first_funding_year,age_last_funding_year,funding_age_years,years_since_last_funding,milestones,age_first_milestone_year,age_last_milestone_year,relationships,funding_total_usd,has_VC,has_angel,avg_participants,status,is_top500
0,0,0,18,3,2,3,1,15,3,5,7,3,375000,0,1,1.0,acquired,0
1,1,1,25,4,5,10,5,15,1,7,7,9,40100000,1,0,4.75,acquired,1
1,1,1,15,1,1,1,0,14,2,1,2,5,2600000,0,0,4.0,acquired,1
1,1,1,23,3,3,5,2,18,1,6,6,5,40000000,0,0,3.3333,acquired,1
1,1,1,2,2,0,2,2,0,1,0,0,2,1300000,1,1,1.0,closed,1
1,1,1,7,1,5,5,0,2,1,5,5,3,7500000,0,0,3.0,closed,1
1,1,1,20,3,2,5,3,15,2,3,7,6,26000000,1,0,1.6667,acquired,1
1,1,1,21,3,2,7,5,14,3,6,7,25,34100000,0,0,3.5,acquired,1
0,0,0,23,3,4,11,7,12,4,8,10,13,9650000,1,0,4.0,acquired,1
1,1,1,19,3,2,5,3,14,4,3,6,14,5750000,1,1,1.0,acquired,1
1,1,1,24,3,5,9,4,15,3,10,11,22,27500000,0,0,1.0,acquired,1
1,1,1,5,5,1,5,4,0,2,-1,5,8,10400000,1,1,1.75,closed,1
0,0,0,8,1,5,5,0,3,0,0,0,0,350000,1,0,1.0,closed,0
0,0,0,17,3,0,2,2,15,3,1,4,15,9950000,0,0,2.3333,acquired,1
0,0,0,24,5,5,9,4,15,1,9,9,12,10700000,0,0,2.5,acquired,1
0,0,0,11,1,7,7,0,4,0,0,0,0,200000,1,0,1.0,closed,0
1,1,1,9,5,3,7,4,2,1,6,6,8,49000000,1,0,3.5,closed,1
1,1,1,24,4,5,7,2,17,3,0,13,7,25000000,0,0,3.5,acquired,1
0,0,0,15,3,1,2,1,13,3,1,3,10,4575000,0,1,5.0,acquired,1
1,1,1,4,2,3,3,0,1,3,3,3,13,28000000,0,0,1.0,closed,1
0,0,0,24,2,2,4,2,20,3,4,9,8,4355000,0,1,1.5,acquired,0
2,2,2,7,1,4,4,0,3,1,4,4,3,15000000,0,0,2.0,closed,1
1,1,1,6,1,5,5,0,1,1,0,0,1,3170000,0,0,2.0,closed,0
1,1,1,5,2,-1,3,4,2,3,4,6,4,2300000,0,1,2.0,closed,0
0,0,0,2,2,0,0,0,2,0,0,0,5,455000,0,1,4.5,closed,1
0,0,0,23,1,5,5,0,18,1,1,1,3,13000000,0,0,4.0,acquired,1
1,1,1,22,1,4,4,0,18,1,3,3,7,15000000,0,0,4.0,acquired,1
1,1,1,16,1,4,4,0,12,3,3,5,2,3800000,0,0,2.0,acquired,1
0,0,0,17,5,3,5,2,12,2,5,6,37,299500000,1,0,1.75,acquired,1
1,1,1,19,1,1,1,0,18,3,2,8,5,1000000,1,0,2.0,acquired,1
1,1,1,5,2,1,2,1,3,1,5,5,3,10500000,0,0,2.0,closed,1
2,2,2,24,2,4,5,1,19,1,3,3,6,8600000,1,0,1.5,acquired,1
0,0,0,5,2,0,2,2,3,0,0,0,9,5000000,0,0,2.5,closed,1
1,1,1,14,2,0,1,1,13,2,0,2,3,2304999,1,0,5.0,acquired,1
0,0,0,2,1,0,0,0,2,0,0,0,2,25000,0,1,1.0,closed,0
0,0,0,4,1,3,3,0,1,1,0,0,1,4000000,0,0,1.0,closed,1
1,1,1,4,2,1,2,1,2,3,1,4,8,14600000,0,0,2.0,closed,1
1,1,1,8,3,1,6,5,2,0,0,0,0,44000000,0,0,4.5,closed,1
1,1,1,16,3,0,3,3,13,3,1,5,10,1822922,0,1,2.3333,acquired,1
0,0,0,18,7,0,6,6,12,5,4,7,18,29915001,1,1,2.75,acquired,1
0,0,0,18,4,0,5,5,13,5,4,8,26,33000000,0,0,3.0,acquired,1
0,0,0,13,2,0,1,1,12,2,1,1,9,125000,0,1,1.0,acquired,0
0,0,0,3,2,0,2,2,1,2,2,3,7,4000000,1,0,1.0,closed,1
2,2,2,20,1,3,3,0,17,3,6,8,10,10000000,0,0,2.0,acquired,1
1,1,1,23,1,5,5,0,18,4,9,10,25,6000000,0,0,3.0,acquired,1
1,1,1,22,1,3,3,0,19,0,0,0,4,25000000,0,0,5.0,acquired,1
0,0,0,15,3,1,3,2,12,3,1,3,2,3750000,0,1,2.0,acquired,1
0,0,0,15,1,0,0,0,15,2,1,2,9,3000000,0,0,1.0,acquired,1
1,1,1,14,2,0,1,1,13,2,1,2,6,1155000,0,1,9.5,acquired,1
1,1,1,22,1,3,3,0,19,2,5,8,11,10000000,0,0,2.0,acquired,1
1,1,1,19,1,3,3,0,16,1,2,2,5,3000000,0,0,1.0,acquired,1
0,0,0,16,2,2,2,0,14,3,2,3,4,11500000,0,0,1.0,acquired,1
0,0,0,20,1,1,1,0,19,5,4,8,12,5000000,0,0,3.0,acquired,1
0,0,0,25,2,5,7,2,18,1,7,7,9,29000000,1,0,5.0,acquired,1
1,1,1,18,6,1,6,5,12,4,4,8,37,34700000,1,1,5.0,acquired,1
1,1,1,5,2,1,3,2,2,0,0,0,0,12050000,1,0,2.0,closed,1
1,1,1,19,3,2,5,3,14,2,4,7,13,12000000,1,0,2.0,acquired,1
1,1,1,19,1,4,4,0,15,1,2,2,18,5500000,0,0,2.0,acquired,1
1,1,1,17,3,2,4,2,13,4,3,5,10,24000000,0,0,3.3333,acquired,1
0,0,0,24,2,5,6,1,18,2,8,13,6,10000000,0,0,4.5,acquired,1
0,0,0,11,3,3,11,8,0,1,-2,-2,10,19009671,0,0,2.0,closed,1
1,1,1,6,1,3,3,0,3,1,3,3,6,5000000,0,0,1.0,closed,1
2,2,2,24,5,4,9,5,15,1,6,6,2,18914576,1,0,3.0,acquired,1
3,3,3,11,1,6,6,0,5,0,0,0,0,4000000,1,0,3.0,closed,0
0,0,0,16,3,1,3,2,13,2,2,3,5,2030882,0,0,3.0,acquired,1
1,1,1,19,1,3,3,0,16,2,0,7,4,5000000,0,0,1.0,acquired,1
2,2,2,12,1,1,1,0,11,0,0,0,5,20500000,1,0,4.0,closed,1
0,0,0,18,2,4,7,3,11,4,5,8,4,13250000,1,0,2.0,acquired,0
1,1,1,25,1,7,7,0,18,1,7,7,7,12000000,0,0,2.0,acquired,1
1,1,1,19,3,1,3,2,16,2,3,3,9,11489687,0,1,3.3333,acquired,1
1,1,1,17,1,1,1,0,16,3,3,4,15,4000000,0,0,3.0,acquired,1
1,1,1,12,1,0,0,0,12,1,0,0,3,355000,0,1,1.0,acquired,0
3,3,3,19,2,0,0,0,19,3,2,5,10,118000,0,1,1.5,acquired,1
1,1,1,-2,4,2,9,7,-11,3,7,10,17,40400000,0,0,1.6667,acquired,1
0,0,0,1,1,2,2,0,-1,0,0,0,1,3000000,0,0,1.0,closed,1
1,1,1,5,2,3,4,1,1,1,1,1,2,19700000,1,0,4.0,closed,1
1,1,1,13,2,9,9,0,4,0,0,0,0,17800000,1,0,1.0,closed,1
1,1,1,14,3,0,2,2,12,3,3,4,12,57500000,0,1,4.0,acquired,1
0,0,0,19,3,1,3,2,16,5,2,5,10,17200000,0,0,2.6667,acquired,1
0,0,0,4,7,-1,1,2,3,2,0,2,4,457282,1,1,1.0,closed,1
1,1,1,14,4,0,2,2,12,3,2,3,11,18500000,0,1,2.25,acquired,1
0,0,0,4,1,2,2,0,2,0,0,0,2,12000000,0,0,6.0,closed,1
0,0,0,5,2,4,4,0,1,3,4,5,5,510000000,1,0,2.5,closed,1
1,1,1,23,2,4,5,1,18,1,4,4,3,18250000,0,0,2.5,acquired,1
0,0,0,20,4,2,6,4,14,5,4,8,13,41500019,0,0,4.0,acquired,1
0,0,0,9,1,5,5,0,4,0,0,0,1,1000000,0,0,3.0,closed,0
1,1,1,18,1,1,1,0,17,2,1,3,7,5000000,0,0,1.0,acquired,1
0,0,0,12,3,8,11,3,1,1,0,0,2,42700000,1,0,3.6667,closed,1
1,1,1,-9,1,1,1,0,-10,0,0,0,7,12000000,1,0,9.0,closed,1
2,2,2,22,2,3,3,0,19,2,3,9,5,22300000,0,0,4.5,acquired,1
1,1,1,23,2,4,8,4,15,1,0,0,5,10000000,1,0,4.0,acquired,1
0,0,0,5,3,1,5,4,0,0,0,0,1,15564591,1,0,3.5,closed,1
1,1,1,18,1,3,3,0,15,2,2,5,7,500000,0,1,5.0,acquired,1
1,1,1,14,2,0,1,1,13,2,2,3,24,8950000,0,0,7.0,acquired,1
0,0,0,19,4,2,5,3,14,2,4,5,8,55350000,0,0,4.0,acquired,1
1,1,1,8,1,4,4,0,4,0,0,0,1,4000000,0,0,3.0,closed,1
0,0,0,19,5,2,7,5,12,3,3,5,3,10764323,1,0,2.0,acquired,1
0,0,0,5,1,1,1,0,4,1,0,0,1,5500000,1,0,3.0,closed,1
1,1,1,17,1,4,4,0,13,2,2,6,7,400000,0,1,3.0,acquired,1
1,1,1,6,3,1,3,2,3,0,0,0,3,54000000,1,0,2.6667,closed,1
0,0,0,24,1,21,21,0,3,0,0,0,2,32000000,0,0,7.0,closed,1
0,0,0,25,1,6,6,0,19,0,0,0,1,13000000,0,0,4.0,acquired,1
2,2,2,20,3,0,1,1,19,0,0,0,5,12500000,1,0,2.3333,acquired,1
1,1,1,21,4,2,8,6,13,2,1,8,16,38064570,1,0,3.0,acquired,1
1,1,1,4,2,0,1,1,3,2,2,5,21,6000000,0,1,4.0,acquired,1
0,0,0,6,2,2,5,3,1,6,1,6,4,5000000,0,0,1.0,closed,0
0,0,0,25,3,0,7,7,18,3,6,11,9,59000000,1,0,2.0,acquired,1
0,0,0,2,1,1,1,0,1,2,0,1,2,1000000,0,1,1.0,closed,0
1,1,1,18,1,3,3,0,15,3,1,6,5,600000,0,1,7.0,acquired,1
0,0,0,6,2,3,3,0,3,2,3,4,0,125000000,0,0,2.0,closed,1
1,1,1,17,2,1,3,2,14,3,3,7,11,2750000,0,1,4.0,acquired,1
1,1,1,22,2,3,5,2,17,0,0,0,1,30000000,0,0,2.5,acquired,1
1,1,1,9,1,4,4,0,5,0,0,0,0,7000000,0,0,1.0,closed,0
1,1,1,19,1,0,0,0,19,2,0,3,10,6100000,0,0,4.0,acquired,1
1,1,1,2,3,1,2,1,0,2,2,3,12,2100000,1,1,4.0,closed,1
1,1,1,15,2,0,1,1,14,3,0,3,10,2565000,0,1,3.5,acquired,1
1,1,1,15,1,11,11,0,4,0,0,0,0,2000000,0,0,1.0,closed,0
0,0,0,22,3,3,6,3,16,1,2,2,3,22400000,1,0,3.6667,acquired,1
0,0,0,19,1,1,1,0,18,1,6,6,12,6250000,0,0,1.0,acquired,0
0,0,0,14,1,2,2,0,12,2,1,2,4,575000,0,1,6.0,acquired,0
0,0,0,2,2,0,1,1,1,1,0,0,1,53000,0,1,1.0,closed,1
1,1,1,19,2,1,3,2,16,2,3,4,6,9500000,0,0,2.5,acquired,1
0,0,0,3,2,-1,1,2,2,2,-2,0,7,3500000,0,1,1.0,closed,1
0,0,0,15,3,1,1,0,14,3,-1,4,14,10500000,1,0,6.3333,acquired,1
1,1,1,17,4,1,4,3,13,2,3,4,14,34250000,1,0,2.25,acquired,1
0,0,0,19,5,1,5,4,14,0,0,0,2,85381111,0,0,4.6667,acquired,1
0,0,0,25,3,6,8,2,17,3,8,11,6,100000000,1,0,2.5,acquired,1
0,0,0,4,2,-1,1,2,3,2,0,1,3,125000,1,1,1.0,closed,1
0,0,0,5,2,2,4,2,1,1,0,0,2,10600000,1,0,3.0,closed,1
1,1,1,21,3,2,5,3,16,1,2,2,2,26100000,1,0,3.5,acquired,1
0,0,0,25,1,8,8,0,17,1,11,11,2,30000000,1,0,5.0,acquired,1
0,0,0,1,3,1,2,1,-1,2,1,1,6,132885,0,1,1.0,closed,1
1,1,1,18,3,1,4,3,14,2,-1,4,9,9500000,0,0,2.0,acquired,1
1,1,1,25,1,6,6,0,19,1,6,6,9,18000000,1,0,7.0,acquired,1
0,0,0,1,1,2,2,0,-1,1,2,2,4,690000,0,1,3.0,closed,1
0,0,0,24,3,5,6,1,18,0,0,0,1,25131611,1,0,1.0,acquired,1
1,1,1,6,1,4,4,0,2,0,0,0,1,2000000,0,0,1.0,closed,1
0,0,0,21,3,2,7,5,14,2,5,7,4,78750000,0,0,3.5,acquired,1
1,1,1,18,5,0,4,4,14,3,3,7,27,48500000,1,1,2.5,acquired,1
1,1,1,8,1,1,1,0,7,2,5,8,12,15000000,0,0,3.0,closed,0
1,1,1,18,5,1,5,4,13,0,0,0,13,74000000,1,0,5.3333,acquired,1
1,1,1,20,2,1,2,1,18,1,2,2,6,15000000,0,0,3.0,acquired,1
0,0,0,5,3,2,4,2,1,3,3,5,8,45000000,0,0,1.0,closed,0
1,1,1,18,1,2,2,0,16,1,2,2,4,4410000,0,0,1.0,acquired,1
0,0,0,15,2,0,1,1,14,2,2,3,9,4500000,0,0,2.0,acquired,1
1,1,1,18,3,2,4,2,14,2,5,6,11,11040000,0,0,2.5,acquired,1
1,1,1,16,1,2,2,0,14,2,1,3,6,1600000,0,0,3.0,acquired,1
0,0,0,23,2,3,4,1,19,1,8,8,3,9000000,1,0,4.0,acquired,1
1,1,1,14,3,1,3,2,11,2,0,4,4,3282327,1,0,2.0,acquired,1
1,1,1,23,2,4,4,0,19,5,6,11,5,24700000,0,0,4.0,acquired,1
0,0,0,8,2,6,7,1,1,0,0,0,2,8800000,1,0,1.0,closed,1
1,1,1,3,1,1,1,0,2,1,1,1,1,1700000,0,0,1.0,closed,0
1,1,1,2,1,0,0,0,2,2,0,1,1,20000,0,1,1.0,closed,0
1,1,1,20,2,3,5,2,15,5,5,8,10,11500000,0,0,2.5,acquired,1
1,1,1,11,7,2,9,7,2,3,4,11,12,98170000,1,0,5.2,closed,1
1,1,1,15,1,1,1,0,14,3,1,3,2,1350000,0,1,10.0,acquired,1
0,0,0,19,1,5,5,0,14,2,3,7,17,940261,0,0,1.0,acquired,1
0,0,0,17,2,2,4,2,13,3,4,4,12,4000000,0,1,3.0,acquired,1
1,1,1,4,1,2,2,0,2,1,1,1,5,5000000,0,0,1.0,closed,0
0,0,0,2,1,0,0,0,2,1,1,1,3,20000,0,1,1.0,closed,0
2,2,2,23,1,4,4,0,19,1,3,3,5,12500000,0,0,3.0,acquired,1
0,0,0,4,5,1,5,4,-1,2,1,1,0,7228704,1,0,2.0,closed,1
0,0,0,7,2,4,6,2,1,1,5,5,5,55000000,1,0,4.0,closed,1
1,1,1,21,4,2,7,5,14,0,0,0,5,15180000,1,0,1.0,acquired,1
1,1,1,4,2,2,3,1,1,2,2,4,4,30000000,0,0,2.5,closed,1
0,0,0,19,2,3,3,0,16,3,3,4,11,14500000,0,0,1.5,acquired,1
1,1,1,16,1,2,2,0,14,3,3,4,6,6500000,1,0,3.0,acquired,1
0,0,0,1,1,0,0,0,1,1,0,0,2,15000,0,1,1.0,closed,0
0,0,0,15,5,1,4,3,11,3,2,4,5,4705910,1,1,3.0,acquired,1
1,1,1,17,1,3,3,0,14,2,3,5,6,3000000,1,0,1.0,acquired,1
0,0,0,17,6,1,5,4,12,5,3,7,30,125250000,1,0,3.5,acquired,1
0,0,0,5,4,0,4,4,1,3,2,4,8,1449998,1,1,1.0,closed,1
0,0,0,13,2,1,1,0,12,3,1,3,5,6000000,0,1,6.0,acquired,1
4,4,4,20,3,2,6,4,14,0,0,0,7,28200000,1,0,3.0,acquired,1
1,1,1,19,2,3,5,2,14,1,5,5,5,14000000,1,0,2.0,acquired,1
0,0,0,1,1,2,2,0,-1,2,2,3,14,3000000,0,0,1.0,closed,0
0,0,0,3,2,2,2,0,1,1,1,1,6,2238055,1,1,1.0,closed,1
1,1,1,2,2,1,2,1,0,2,2,2,5,5200000,1,0,1.0,closed,1
0,0,0,15,1,4,4,0,11,4,1,4,4,75000000,1,0,1.0,acquired,0
0,0,0,5,4,0,4,4,1,4,4,6,13,24500000,0,0,2.5,closed,1
1,1,1,10,3,5,8,3,2,0,0,0,3,4476171,1,0,2.0,closed,1
0,0,0,17,3,1,2,1,15,3,3,6,21,10400001,0,0,6.0,acquired,1
0,0,0,23,3,4,7,3,16,1,5,5,8,68400000,1,0,6.5,acquired,1
1,1,1,21,2,3,5,2,16,0,0,0,13,15200000,0,0,2.0,acquired,1
0,0,0,2,2,1,2,1,0,0,0,0,2,890000,0,1,3.0,closed,1
1,1,1,11,1,11,11,0,0,0,0,0,0,2600000,1,0,1.0,closed,1
0,0,0,16,1,4,4,0,12,2,4,4,7,1226270,0,1,1.0,acquired,1
1,1,1,23,2,7,8,1,15,1,7,7,5,9000000,0,0,1.0,acquired,0
1,1,1,21,4,5,8,3,13,1,6,6,4,7210210,1,0,1.0,acquired,0
1,1,1,14,2,1,1,0,13,1,1,1,15,15700000,0,0,3.0,acquired,1
0,0,0,25,2,6,6,0,19,1,5,5,4,15050000,1,0,2.5,acquired,1
1,1,1,18,2,1,3,2,15,2,2,5,5,3500000,0,0,3.0,acquired,1
1,1,1,9,2,6,7,1,2,1,5,5,2,43000000,0,0,1.0,closed,1
1,1,1,20,2,1,3,2,17,2,3,6,7,57000000,0,0,3.5,acquired,1
1,1,1,17,1,1,1,0,16,4,1,4,8,1300000,0,1,4.0,acquired,1
1,1,1,21,4,1,4,3,17,4,4,10,15,69750000,0,0,5.0,acquired,1
0,0,0,24,2,3,5,2,19,2,10,10,16,14500000,0,1,2.0,acquired,1
1,1,1,7,2,4,6,2,1,0,0,0,2,48000000,0,0,6.0,closed,1
0,0,0,6,2,4,5,1,1,0,0,0,3,3508462,1,0,3.0,closed,1
1,1,1,23,3,3,6,3,17,1,8,8,10,19500000,0,0,3.3333,acquired,1
1,1,1,13,1,0,0,0,13,3,1,2,5,3750000,0,0,9.0,acquired,1
0,0,0,1,1,0,0,0,1,0,0,0,1,45000000,0,0,2.0,closed,0
0,0,0,8,4,1,6,5,2,3,5,8,8,32500000,0,0,2.75,closed,1
0,0,0,24,2,2,8,6,16,5,6,14,4,4900000,0,1,1.5,acquired,1
1,1,1,6,2,2,3,1,3,3,4,5,4,12000000,0,0,2.0,closed,1
1,1,1,18,3,0,2,2,16,6,5,7,12,7175000,0,1,2.6667,acquired,1
1,1,1,4,2,1,1,0,3,4,0,5,3,4700000,0,1,1.5,closed,1
-1,-1,-1,2,1,0,0,0,2,0,0,0,3,120000,0,1,2.0,closed,0
1,1,1,22,3,5,9,4,13,2,6,7,10,10000000,1,0,1.6667,acquired,0
0,0,0,12,4,5,10,5,2,0,0,0,0,39000000,1,0,3.0,closed,0
0,0,0,22,2,2,4,2,18,0,0,0,3,16100000,0,0,2.5,acquired,1
1,1,1,19,2,1,2,1,17,3,2,5,4,3300000,0,1,2.0,acquired,1
1,1,1,15,1,2,2,0,13,3,1,2,6,750000,0,1,9.0,acquired,1
0,0,0,6,2,2,2,0,4,0,0,0,0,1000000,1,1,2.0,closed,0
0,0,0,13,1,11,11,0,2,0,0,0,3,7410000,1,0,3.0,closed,1
1,1,1,25,3,7,10,3,15,0,0,0,5,52800000,1,0,5.3333,acquired,1
1,1,1,10,3,5,9,4,1,4,10,13,33,37000000,0,0,1.3333,closed,1
1,1,1,17,3,1,4,3,13,3,2,3,14,14229998,0,0,3.0,acquired,1
1,1,1,16,2,1,2,1,14,2,1,3,7,3000000,0,0,2.5,acquired,1
0,0,0,20,1,4,4,0,16,1,6,6,10,20000000,0,0,1.0,acquired,0
-1,-1,-1,16,2,1,2,1,14,3,2,2,6,2000000,0,1,1.5,acquired,1
0,0,0,22,2,4,6,2,16,2,9,10,3,19900000,1,0,2.0,acquired,1
1,1,1,2,1,1,1,0,1,1,3,3,6,1500000,0,0,1.0,closed,0
1,1,1,2,1,0,0,0,2,1,1,1,4,325000,0,1,4.0,closed,0
1,1,1,2,1,0,0,0,2,2,1,2,16,3500000,0,0,5.0,closed,1
2,2,2,8,4,2,4,2,4,2,2,4,7,30000000,0,1,2.0,closed,1
0,0,0,22,1,4,4,0,18,0,0,0,1,50000000,0,0,6.0,acquired,1
0,0,0,17,1,1,1,0,16,2,1,1,5,2000000,0,0,3.0,acquired,1
1,1,1,19,6,2,6,4,13,2,6,8,25,72000000,1,0,2.3333,acquired,1
1,1,1,21,3,2,6,4,15,1,8,8,4,27690547,0,0,4.5,acquired,1
0,0,0,6,1,2,2,0,4,0,0,0,32,9000000,0,0,4.0,closed,1
1,1,1,16,2,0,1,1,15,3,3,4,12,7500000,0,0,3.5,acquired,1
0,0,0,18,2,1,1,0,17,1,3,3,9,10000000,0,0,2.0,acquired,1
1,1,1,19,4,1,7,6,12,1,2,2,7,5965000,1,0,1.0,acquired,0
1,1,1,18,1,0,0,0,18,4,0,7,9,4000000,0,0,1.0,acquired,0
0,0,0,10,1,5,5,0,5,1,7,7,2,5000000,1,0,1.0,closed,0
1,1,1,21,1,1,1,0,20,2,5,7,15,11500000,0,0,2.0,acquired,1
0,0,0,4,2,1,2,1,2,1,2,2,2,1050000,1,0,1.0,closed,0
0,0,0,18,2,1,1,0,17,2,1,3,13,5500000,0,0,2.0,acquired,1
0,0,0,17,3,1,3,2,14,4,1,3,17,5000000,0,1,1.6667,acquired,1
1,1,1,2,2,-1,1,2,1,3,-1,2,11,3700000,1,0,3.0,closed,0
1,1,1,5,2,1,3,2,2,0,0,0,4,7000000,0,0,2.0,closed,0
0,0,0,7,2,1,2,1,5,4,2,4,14,32000000,0,0,3.5,closed,1
0,0,0,18,3,1,4,3,14,2,3,3,8,7900000,0,0,2.0,acquired,0
1,1,1,18,5,1,6,5,12,3,3,7,16,80000000,0,1,2.25,acquired,1
0,0,0,7,1,5,5,0,2,1,0,0,1,5000000,1,0,1.0,closed,1
2,2,2,19,2,1,3,2,16,3,2,8,5,2100000,0,1,1.5,acquired,1
0,0,0,20,4,0,4,4,16,1,3,3,6,22250000,0,0,2.5,acquired,1
2,2,2,13,2,1,2,1,11,2,-14,2,6,1975000,1,1,3.0,acquired,0
0,0,0,17,1,0,0,0,17,2,4,4,0,1000000,0,1,1.0,acquired,1
0,0,0,5,1,2,2,0,3,0,0,0,0,35000000,0,0,1.0,closed,0
1,1,1,19,7,0,4,4,15,5,4,6,12,88651133,1,1,3.1667,acquired,1
0,0,0,25,1,6,6,0,19,0,0,0,3,26000000,1,0,2.0,acquired,1
1,1,1,1,1,1,1,0,0,2,0,1,3,100000,0,1,1.0,closed,0
0,0,0,19,1,1,1,0,18,3,4,5,6,5000000,0,0,1.0,acquired,1
0,0,0,12,2,7,8,1,4,0,0,0,5,7300000,1,0,3.0,closed,1
1,1,1,22,3,2,6,4,16,2,4,11,8,64080000,0,0,4.0,acquired,1
-1,-1,-1,14,2,1,2,1,12,2,0,2,8,5800000,0,1,4.0,acquired,1
1,1,1,5,4,4,6,2,-1,2,6,6,6,89500000,0,0,1.0,closed,1
1,1,1,18,4,1,5,4,13,2,3,4,11,23350000,0,1,3.0,acquired,1
0,0,0,22,2,4,6,2,16,0,0,0,7,13500000,1,0,2.5,acquired,1
0,0,0,25,2,7,8,1,17,2,11,11,13,24500000,0,0,5.5,acquired,1
1,1,1,11,1,4,4,0,7,1,3,3,2,10000000,0,0,4.0,closed,1
0,0,0,5,1,-2,-2,0,7,0,0,0,3,8500000,1,0,1.0,closed,0
0,0,0,19,1,16,16,0,3,0,0,0,0,6000000,0,0,3.0,closed,0
1,1,1,16,1,1,1,0,15,1,1,1,3,2000000,0,0,2.0,acquired,1
0,0,0,14,2,1,2,1,12,2,0,1,3,4100000,0,0,1.5,acquired,1
1,1,1,20,1,0,0,0,20,4,2,8,5,6200000,0,0,2.0,acquired,1
1,1,1,22,2,4,6,2,16,1,4,4,8,12250000,0,0,2.5,acquired,1
1,1,1,21,2,3,5,2,16,2,6,9,3,11725600,0,0,2.0,acquired,1
0,0,0,6,2,4,6,2,0,0,0,0,1,16000000,0,0,3.0,closed,1
2,2,2,18,3,2,4,2,14,2,3,5,10,5056559,1,0,1.6667,acquired,1
1,1,1,20,1,0,0,0,20,3,7,9,9,100000,0,1,1.0,acquired,1
1,1,1,23,3,2,7,5,16,3,4,8,11,68200000,1,1,4.0,acquired,1
1,1,1,24,3,4,9,5,15,1,6,6,5,33000000,1,0,3.6667,acquired,1
0,0,0,4,3,2,3,1,1,2,2,2,8,3352194,0,1,9.5,closed,0
0,0,0,14,2,1,2,1,12,2,0,2,5,2212000,0,1,3.0,acquired,1
1,1,1,21,4,6,7,1,14,0,0,0,1,19800000,1,0,5.0,acquired,1
1,1,1,3,2,1,1,0,2,2,1,1,6,4500000,0,1,3.0,closed,1
0,0,0,21,2,4,4,0,17,1,4,4,2,14000000,1,0,1.5,acquired,1
-1,-1,-1,1,1,0,0,0,1,2,0,0,4,100000,0,1,1.0,closed,0
1,1,1,21,2,2,3,1,18,2,3,5,4,9900000,0,0,2.0,acquired,1
1,1,1,17,3,0,5,5,12,2,5,6,10,7600000,0,0,5.0,acquired,1
1,1,1,3,1,0,0,0,3,1,1,1,2,50000,0,1,2.0,closed,0
1,1,1,4,1,0,0,0,4,0,0,0,3,650000,0,1,1.0,closed,0
1,1,1,3,3,1,3,2,0,3,2,3,8,10500000,1,0,2.0,closed,1
1,1,1,13,1,0,0,0,13,2,0,1,12,500000,0,1,1.0,acquired,0
1,1,1,22,2,2,4,2,18,3,2,10,2,24300000,0,0,2.5,acquired,1
1,1,1,10,2,7,8,1,2,1,7,7,6,18000000,1,0,4.0,closed,1
1,1,1,17,3,1,4,3,13,5,4,7,27,26000000,0,0,3.6667,acquired,1
1,1,1,7,2,2,5,3,2,0,0,0,2,9500000,1,0,3.0,closed,1
0,0,0,9,1,7,7,0,2,1,5,5,6,16980999,0,0,1.0,acquired,1
1,1,1,5,1,1,1,0,4,2,1,4,2,5000000,0,0,3.0,closed,0
2,2,2,4,1,2,2,0,2,0,0,0,3,350000,1,0,1.0,closed,0
0,0,0,7,5,1,5,4,2,1,1,1,1,13130000,1,0,2.0,closed,1
0,0,0,3,1,3,3,0,0,2,0,3,1,20000000,0,0,1.0,closed,0
0,0,0,18,3,1,3,2,15,4,2,7,18,26500000,1,0,2.0,acquired,1
0,0,0,23,2,4,4,0,19,0,0,0,4,15000000,0,0,5.0,acquired,1
0,0,0,10,1,4,4,0,6,0,0,0,0,2600000,0,0,1.0,closed,0
1,1,1,8,4,2,6,4,2,0,0,0,1,21470000,0,0,3.5,closed,1
0,0,0,2,1,0,0,0,2,2,0,1,5,20000,0,1,1.0,closed,0
1,1,1,7,2,2,3,1,4,3,2,7,10,3600000,0,1,1.0,closed,0
0,0,0,19,7,1,7,6,12,4,8,8,23,27300000,0,1,2.0,acquired,1
1,1,1,13,1,1,1,0,12,1,1,1,8,2600000,0,0,2.0,acquired,0
1,1,1,0,1,1,1,0,-1,2,0,1,5,5000000,0,0,1.0,closed,1
1,1,1,21,2,5,6,1,15,2,4,6,2,17000000,0,0,3.5,acquired,1
0,0,0,5,1,4,4,0,1,0,0,0,0,662000,0,0,3.0,closed,0
0,0,0,15,2,0,1,1,14,2,2,3,12,3750000,0,1,4.0,acquired,1
1,1,1,20,4,1,7,6,13,8,5,9,57,45000000,0,0,4.6667,acquired,1
0,0,0,17,2,4,6,2,11,4,3,6,9,6700000,1,0,8.0,acquired,1
1,1,1,19,3,0,4,4,15,2,2,4,12,20750000,1,0,2.3333,acquired,1
1,1,1,19,4,1,8,7,11,0,0,0,5,19000000,0,0,2.0,acquired,1
1,1,1,18,3,0,1,1,17,0,0,0,20,22500000,1,0,4.0,acquired,1
1,1,1,19,3,1,3,2,16,3,2,4,10,7300000,0,1,2.0,acquired,1
0,0,0,7,7,1,8,7,-1,3,4,6,16,26390819,1,0,1.3333,closed,1
2,2,2,20,1,4,4,0,16,0,0,0,4,10000000,0,0,3.0,acquired,1
0,0,0,2,1,0,0,0,2,1,0,0,1,31000,0,1,2.0,closed,0
1,1,1,19,3,2,3,1,16,4,2,6,16,21500000,0,0,3.3333,acquired,1
0,0,0,23,1,5,5,0,18,1,7,7,5,4000000,0,0,5.0,acquired,1
1,1,1,18,3,1,4,3,14,4,3,4,5,9400000,1,0,4.0,acquired,1
1,1,1,17,3,0,2,2,15,4,2,5,9,5600000,0,0,2.0,acquired,1
1,1,1,18,2,2,3,1,15,2,4,5,9,6000000,0,0,2.5,acquired,1
0,0,0,24,4,2,10,8,14,3,10,12,35,60704370,1,0,2.0,acquired,1
1,1,1,15,3,1,3,2,12,2,4,5,16,2000000,0,1,3.6667,acquired,1
1,1,1,16,2,0,1,1,15,3,1,2,5,1000000,1,0,5.5,acquired,1
0,0,0,4,2,1,1,0,3,2,1,1,3,200000,0,1,2.0,closed,1
1,1,1,4,1,2,2,0,2,2,0,2,2,2300000,0,0,2.0,closed,1
1,1,1,3,1,2,2,0,1,4,1,3,5,1000000,0,0,1.0,closed,1
1,1,1,21,5,1,6,5,15,3,5,7,13,24750000,1,1,2.4,acquired,1
0,0,0,8,2,3,6,3,2,1,7,7,15,12800000,0,0,2.0,closed,1
1,1,1,24,2,4,7,3,17,1,7,7,10,30500000,0,0,4.5,acquired,1
1,1,1,8,3,6,9,3,-1,2,6,8,3,36300000,1,0,1.5,closed,1
1,1,1,17,3,2,3,1,14,3,3,5,7,6693782,1,0,1.6667,acquired,1
1,1,1,14,1,11,11,0,3,0,0,0,1,20000000,0,0,5.0,closed,1
1,1,1,20,1,3,3,0,17,3,4,6,8,11370000,0,0,2.0,acquired,1
1,1,1,18,3,1,3,2,15,4,4,6,13,16500000,0,0,1.3333,acquired,1
1,1,1,3,1,0,0,0,3,1,3,3,3,250000,0,1,3.0,closed,0
0,0,0,18,5,1,3,2,15,5,3,7,9,14400000,0,1,5.8,acquired,1
0,0,0,17,5,0,4,4,13,3,5,5,24,90000000,1,0,3.8,acquired,1
1,1,1,19,4,1,7,6,12,2,6,8,10,13075000,0,0,4.0,acquired,1
1,1,1,17,2,0,0,0,17,4,0,6,10,26000000,0,0,2.5,acquired,1
0,0,0,17,2,3,4,1,13,2,3,5,6,16300000,0,0,2.0,acquired,1
0,0,0,10,2,4,7,3,3,1,7,7,5,5992316,1,0,2.0,acquired,0
1,1,1,18,4,3,5,2,13,0,0,0,2,89400001,1,0,4.3333,acquired,1
1,1,1,6,1,1,1,0,5,1,5,5,4,1200000,0,0,1.0,closed,0
0,0,0,3,2,1,1,0,2,2,1,3,7,1900000,0,1,2.5,closed,1
1,1,1,13,3,9,12,3,1,2,7,11,9,30300000,1,0,4.5,closed,1
0,0,0,5,1,2,2,0,3,0,0,0,4,500000,0,1,5.0,closed,0
1,1,1,18,5,0,7,7,11,2,6,7,19,74000000,0,1,1.75,acquired,1
0,0,0,25,1,7,7,0,18,0,0,0,3,18800000,0,0,7.0,acquired,1
0,0,0,0,1,0,0,0,0,1,0,0,3,20000,0,1,1.0,closed,0
0,0,0,16,4,0,2,2,14,2,2,2,3,3350000,0,1,1.5,acquired,0
0,0,0,20,1,5,5,0,15,0,0,0,1,26100000,1,0,2.0,acquired,1
0,0,0,4,2,1,3,2,1,0,0,0,0,1213066,1,0,1.0,closed,1
1,1,1,17,3,1,4,3,13,3,1,5,18,24030000,0,0,3.6667,acquired,1
1,1,1,18,3,0,3,3,15,5,2,6,14,13100000,0,1,1.6667,acquired,1
0,0,0,16,3,0,2,2,14,5,0,5,6,560001,1,1,3.5,acquired,1
4,4,4,16,1,3,3,0,13,3,3,4,7,3500000,0,0,2.0,acquired,1
0,0,0,20,7,0,8,8,12,3,7,9,45,121500000,1,0,4.5,acquired,1
1,1,1,20,4,1,4,3,16,1,2,2,18,42500000,1,0,2.5,acquired,1
0,0,0,25,2,5,6,1,19,1,6,6,26,36000000,1,0,3.5,acquired,1
1,1,1,7,1,3,3,0,4,2,3,5,7,12170000,0,0,3.0,closed,1
0,0,0,23,1,6,6,0,17,2,8,10,4,1000000,0,0,3.0,acquired,1
0,0,0,16,3,3,4,1,12,4,-2,5,5,1820000,0,1,1.0,acquired,0
0,0,0,21,4,5,9,4,12,2,5,10,19,5700000000,0,0,4.25,acquired,1
0,0,0,24,1,7,7,0,17,2,0,12,6,5000000,0,0,5.0,acquired,1
0,0,0,15,2,1,1,0,14,1,2,2,4,18800000,0,0,2.5,acquired,1
1,1,1,22,2,2,3,1,19,0,0,0,3,72300000,0,0,4.5,acquired,1
1,1,1,15,3,0,3,3,12,4,-2,4,3,1310000,0,1,1.0,acquired,0
0,0,0,8,2,2,5,3,3,1,4,4,2,15000000,0,0,2.5,closed,1
0,0,0,20,3,2,5,3,15,5,5,7,22,39007789,0,0,3.0,acquired,1
0,0,0,21,1,2,2,0,19,1,-2,-2,3,25000000,0,0,5.0,acquired,1
0,0,0,16,3,0,2,2,14,2,1,3,4,172500,0,1,1.0,acquired,0
0,0,0,15,2,2,2,0,13,2,2,4,23,6100000,0,0,1.0,acquired,1
1,1,1,21,3,2,8,6,13,5,2,9,7,40300000,1,0,4.0,acquired,1
1,1,1,0,1,0,0,0,0,3,0,1,9,100000,0,1,1.0,closed,0
2,2,2,17,5,0,5,5,12,2,3,6,14,19389998,1,0,1.5,acquired,1
1,1,1,25,2,2,5,3,20,3,6,12,21,61500000,0,0,4.0,acquired,1
1,1,1,18,1,3,3,0,15,2,4,6,6,6000000,0,0,2.0,acquired,1
0,0,0,21,4,0,5,5,16,6,5,7,23,19100000,0,0,2.5,acquired,1
0,0,0,16,4,0,2,2,14,3,0,4,8,3499997,1,0,1.5,acquired,1
1,1,1,5,3,1,2,1,3,2,5,5,13,2600000,0,1,3.6667,acquired,1
1,1,1,15,3,0,1,1,14,2,3,4,14,2023000,0,1,1.3333,acquired,1
1,1,1,23,1,5,5,0,18,0,0,0,3,25000000,1,0,4.0,acquired,1
1,1,1,15,4,1,4,3,11,4,3,4,17,66000000,1,0,2.3333,acquired,1
0,0,0,15,2,1,1,0,14,1,2,2,5,1000000,0,1,3.5,acquired,0
1,1,1,15,2,1,2,1,13,2,3,4,11,13000000,0,0,3.0,acquired,1
0,0,0,14,3,8,14,6,0,2,13,14,3,24150000,1,0,2.3333,closed,1
1,1,1,9,3,6,8,2,1,0,0,0,4,47218498,1,0,3.3333,closed,1
0,0,0,23,2,4,4,0,19,2,0,8,1,11800000,0,0,4.5,acquired,1
1,1,1,2,2,2,2,0,0,1,0,0,2,2387481,1,0,1.0,closed,1
0,0,0,25,4,1,8,7,17,5,12,14,35,33000000,1,0,2.5,acquired,1
0,0,0,20,2,3,4,1,16,3,4,7,4,7500000,0,0,1.5,acquired,1
1,1,1,25,1,7,7,0,18,1,4,4,3,25000000,0,0,1.0,acquired,1
1,1,1,23,4,4,9,5,14,1,4,4,7,25305000,1,0,2.0,acquired,1
1,1,1,17,2,1,2,1,15,3,2,4,21,4950000,0,1,12.5,acquired,1
1,1,1,21,6,2,6,4,15,0,0,0,8,53816776,1,0,5.0,acquired,1
1,1,1,19,2,0,1,1,18,4,3,8,15,3500000,0,0,5.5,acquired,1
1,1,1,17,1,5,5,0,12,2,5,6,7,5000000,0,0,1.0,acquired,0
1,1,1,17,3,0,3,3,14,3,4,6,9,2515000,1,1,1.6667,acquired,1
0,0,0,19,2,1,2,1,17,3,3,5,10,8400000,0,0,2.0,acquired,1
1,1,1,4,2,3,4,1,0,3,2,5,5,4900000,0,0,1.0,closed,1
2,2,2,11,1,4,4,0,7,1,5,5,3,5000000,1,0,5.0,closed,1
0,0,0,24,1,4,4,0,20,0,0,0,2,11000000,0,0,3.0,acquired,1
1,1,1,25,4,1,8,7,17,0,0,0,6,68400000,1,0,4.0,acquired,1
1,1,1,18,2,3,4,1,14,2,4,5,7,2000000,0,1,8.5,acquired,1
0,0,0,2,2,1,2,1,0,1,0,0,2,10800000,1,0,2.0,closed,1
0,0,0,19,5,0,5,5,14,3,6,7,31,37000000,1,0,2.5,acquired,1
1,1,1,21,1,3,3,0,18,3,4,10,5,7660000,0,0,6.0,acquired,1
0,0,0,20,4,0,5,5,15,3,3,6,5,48730000,1,0,3.0,acquired,1
1,1,1,3,2,0,1,1,2,1,1,1,1,3350000,0,1,2.5,closed,1
1,1,1,9,4,4,7,3,2,2,3,7,3,28000000,1,0,3.0,closed,1
0,0,0,15,1,1,1,0,14,1,2,2,5,2500000,0,0,2.0,acquired,1
0,0,0,20,2,0,1,1,19,4,2,9,16,8000000,0,0,4.0,acquired,1
0,0,0,17,2,1,2,1,15,2,1,4,6,540000,0,1,2.5,acquired,1
1,1,1,19,2,0,1,1,18,4,1,5,4,3100000,0,1,2.0,acquired,1
0,0,0,15,2,1,2,1,13,2,3,5,8,1200000,0,1,6.0,acquired,1
0,0,0,1,1,0,0,0,1,1,0,0,2,5000000,0,0,2.0,closed,0
1,1,1,20,6,1,7,6,13,1,2,2,6,37079000,1,0,3.8,acquired,1
0,0,0,23,4,4,11,7,12,2,9,9,3,135826373,0,0,4.3333,acquired,1
1,1,1,4,2,0,0,0,4,0,0,0,5,5000000,1,1,1.0,closed,1
0,0,0,14,4,0,1,1,13,3,0,3,3,4200000,0,1,3.0,acquired,1
2,2,2,6,1,4,4,0,2,3,-1,8,3,4100000,1,0,1.0,closed,1
1,1,1,1,1,1,1,0,0,2,0,1,3,2000000,0,0,1.0,closed,0
0,0,0,24,1,5,5,0,19,1,5,5,3,6500000,1,0,1.0,acquired,1
1,1,1,6,1,1,1,0,5,0,0,0,0,4000000,0,0,3.0,closed,0
1,1,1,3,5,0,1,1,2,1,1,1,3,185000,1,1,2.0,closed,1
2,2,2,15,1,3,3,0,12,2,3,4,5,1300000,0,0,1.0,acquired,0
0,0,0,22,1,4,4,0,18,0,0,0,21,45000000,0,0,1.0,acquired,0
0,0,0,16,1,2,2,0,14,3,0,2,4,2500000,0,0,2.0,acquired,1
0,0,0,19,2,1,3,2,16,2,2,5,11,9200000,0,0,1.0,acquired,1
1,1,1,2,4,-1,0,1,2,0,0,0,0,435953,0,1,1.0,closed,0
-1,-1,-1,2,2,-1,0,1,2,2,-2,1,9,55600000,0,0,2.0,closed,0
0,0,0,24,1,6,6,0,18,1,1,1,2,10000000,1,0,1.0,acquired,0
2,2,2,1,1,1,1,0,0,1,1,1,3,12000,0,1,1.0,closed,1
0,0,0,6,2,4,4,0,2,0,0,0,3,2257464,1,0,1.0,closed,0
0,0,0,13,2,0,1,1,12,2,0,2,4,983000,0,1,6.0,acquired,1
1,1,1,17,2,1,3,2,14,2,3,4,15,41000000,0,0,1.5,acquired,1
0,0,0,7,3,4,6,2,1,0,0,0,0,9100000,1,0,1.0,closed,0
1,1,1,8,3,2,7,5,1,3,-2,7,6,25500100,1,0,2.5,closed,1
1,1,1,15,1,0,0,0,15,2,2,2,3,400000,0,1,1.0,acquired,1
0,0,0,23,10,5,8,3,15,0,0,0,4,22165091,1,0,2.0,acquired,1
1,1,1,17,1,0,0,0,17,2,1,3,4,500000,0,0,4.0,acquired,1
1,1,1,19,5,1,6,5,13,4,6,9,29,70000000,0,0,2.8,acquired,1
0,0,0,17,2,1,3,2,14,1,3,3,6,4700000,1,0,1.0,acquired,1
0,0,0,2,1,2,2,0,0,1,0,0,1,30000000,1,0,2.0,acquired,1
0,0,0,22,5,2,9,7,13,1,7,7,13,39000000,0,0,3.25,acquired,1
1,1,1,25,3,6,9,3,16,1,10,10,10,32000000,0,0,3.0,acquired,1
0,0,0,25,3,0,1,1,24,0,0,0,7,42000000,0,0,2.6667,acquired,1
1,1,1,24,3,4,9,5,15,2,4,9,5,24510540,1,0,2.6667,acquired,1
1,1,1,11,1,6,6,0,5,0,0,0,0,2500000,1,0,2.0,closed,1
3,3,3,23,3,4,8,4,15,2,9,9,1,21460663,0,0,4.5,acquired,1
0,0,0,24,1,5,5,0,19,0,0,0,6,15000000,0,0,4.0,acquired,1
1,1,1,7,2,1,4,3,3,2,1,5,5,889999,1,1,3.5,closed,1
1,1,1,24,1,4,4,0,20,1,3,3,6,16000000,0,0,3.0,acquired,1
1,1,1,19,1,2,2,0,17,4,3,8,5,7000000,0,0,2.0,acquired,1
0,0,0,3,2,1,1,0,2,0,0,0,3,100000,0,1,1.0,closed,0
0,0,0,17,1,2,2,0,15,3,2,4,13,1500000,0,0,1.0,acquired,0
2,2,2,25,1,6,6,0,19,4,10,13,19,8000000,1,0,1.0,acquired,1
1,1,1,17,2,0,1,1,16,4,4,6,22,4000000,0,0,3.0,acquired,1
1,1,1,2,1,0,0,0,2,0,0,0,3,25000,0,1,1.0,closed,0
1,1,1,22,6,2,9,7,13,3,9,10,10,64630000,1,0,3.6667,acquired,1
0,0,0,6,2,1,4,3,2,1,3,3,10,12100000,0,0,1.0,closed,1
1,1,1,24,2,4,6,2,18,1,5,5,9,20000000,0,0,4.5,acquired,1
0,0,0,10,4,2,9,7,1,1,9,9,10,49600000,0,0,2.6667,closed,1
1,1,1,25,5,8,10,2,15,1,0,0,3,51450000,1,0,5.6667,acquired,1
1,1,1,16,2,0,3,3,13,1,5,5,7,6300000,0,0,2.0,acquired,1
0,0,0,3,1,2,2,0,1,3,1,3,8,200000,0,1,2.0,closed,1
0,0,0,1,1,0,0,0,1,1,0,0,2,20000,0,1,1.0,closed,0
0,0,0,22,2,0,3,3,19,3,7,9,13,11600000,0,0,2.0,acquired,1
1,1,1,18,1,0,0,0,18,2,0,5,6,9150000,0,0,2.0,acquired,1
0,0,0,4,1,0,0,0,4,2,0,0,2,1200000,0,0,4.0,closed,1
1,1,1,1,1,2,2,0,-1,2,1,1,4,1700000,0,0,7.0,closed,1
0,0,0,4,3,1,3,2,1,4,1,5,9,1415000,1,1,1.0,acquired,1
1,1,1,20,2,1,3,2,17,2,6,8,16,4200000,0,0,1.5,acquired,1
0,0,0,18,2,1,2,1,16,2,5,6,7,500000,0,1,2.0,acquired,0
0,0,0,23,1,6,6,0,17,0,0,0,1,21500000,0,0,4.0,acquired,1
0,0,0,18,2,0,2,2,16,2,2,4,4,10000000,0,0,2.0,acquired,0
1,1,1,7,2,1,3,2,4,1,4,4,7,9500000,0,0,2.5,closed,1
1,1,1,5,2,3,5,2,0,0,0,0,4,13875001,0,0,10.0,closed,1
0,0,0,13,1,11,11,0,2,1,9,9,5,275000,0,1,2.0,closed,0
1,1,1,20,3,0,5,5,15,1,2,2,10,19743770,0,0,2.5,acquired,1
0,0,0,16,5,2,4,2,12,1,3,3,5,1178000,0,1,5.0,acquired,1
1,1,1,20,3,1,3,2,17,2,2,4,5,25000000,0,0,2.0,acquired,1
0,0,0,21,3,2,3,1,18,0,0,0,1,24150000,1,0,2.0,acquired,1
1,1,1,4,2,2,4,2,0,1,2,2,4,80000000,0,0,1.0,closed,0
1,1,1,21,2,1,3,2,18,3,4,10,11,36000000,0,0,3.5,acquired,1
0,0,0,3,1,1,1,0,2,0,0,0,1,205000,0,1,1.0,closed,0
1,1,1,22,4,0,4,4,18,4,6,9,27,28300000,0,0,2.5,acquired,1
1,1,1,5,1,-1,-1,0,6,1,1,1,1,2000000,0,0,1.0,closed,0
1,1,1,19,2,1,1,0,18,6,2,9,63,11500000,0,0,1.0,acquired,1
0,0,0,2,1,1,1,0,1,2,1,3,15,4000000,0,0,3.0,closed,1
0,0,0,2,1,1,1,0,1,2,1,2,2,500000,0,1,1.0,closed,1
0,0,0,3,1,1,1,0,2,2,1,4,9,4000000,0,0,2.0,closed,1
0,0,0,2,2,0,2,2,0,2,2,2,8,9030000,0,1,4.0,closed,1
0,0,0,20,4,0,4,4,16,0,0,0,15,69900000,0,1,4.75,acquired,1
1,1,1,1,1,1,1,0,0,1,0,0,2,20000,0,1,1.0,closed,0
0,0,0,24,7,4,12,8,12,3,11,13,29,238209999,1,0,2.0,acquired,1
0,0,0,21,3,3,7,4,14,2,4,7,3,14700000,1,0,1.0,acquired,0
1,1,1,18,3,0,1,1,17,2,-1,1,4,430000,0,1,1.6667,acquired,0
1,1,1,13,2,1,1,0,12,1,1,1,5,1015000,1,0,1.0,acquired,0
1,1,1,3,1,0,0,0,3,1,1,1,2,1200000,1,0,2.0,closed,1
0,0,0,19,2,2,3,1,16,4,3,8,16,17100000,0,0,2.5,acquired,1
0,0,0,21,1,5,5,0,16,1,6,6,0,50000000,1,0,4.0,acquired,1
1,1,1,6,1,1,1,0,5,0,0,0,3,900000,0,0,1.0,closed,1
1,1,1,19,1,17,17,0,2,2,17,18,7,6000000,0,0,1.0,closed,1
0,0,0,23,2,1,7,6,16,3,8,10,5,15100000,0,1,1.0,acquired,0
1,1,1,24,5,1,9,8,15,2,4,9,7,62600000,1,0,9.3333,acquired,1
1,1,1,18,4,2,5,3,13,3,4,6,15,14800000,1,0,2.25,acquired,1
1,1,1,16,2,0,3,3,13,5,2,4,30,6875000,1,0,7.0,acquired,1
0,0,0,3,1,1,1,0,2,0,0,0,1,30000,0,1,1.0,closed,0
1,1,1,7,1,6,6,0,1,1,6,6,10,22200000,0,0,9.0,closed,1
0,0,0,17,2,0,0,0,17,2,0,3,6,415000,0,1,1.0,acquired,1
0,0,0,17,4,0,4,4,13,4,3,5,16,27063781,0,0,3.5,acquired,1
1,1,1,22,1,3,3,0,19,1,5,5,6,3100000,0,0,5.0,acquired,1
1,1,1,5,2,2,3,1,2,4,3,8,13,33000000,0,0,2.5,closed,1
1,1,1,22,3,3,5,2,17,2,4,11,2,17400000,1,0,5.0,acquired,1
1,1,1,20,5,0,3,3,17,4,5,9,17,28300000,0,1,2.0,acquired,1
1,1,1,18,4,0,2,2,16,6,1,7,42,46800000,0,0,2.5,acquired,1
0,0,0,16,3,1,2,1,14,2,2,2,5,1525000,0,1,2.6667,acquired,1
0,0,0,13,1,0,0,0,13,3,1,2,9,1200000,0,1,5.0,acquired,1
1,1,1,19,3,0,4,4,15,4,4,7,6,12400000,1,0,1.6667,acquired,1
0,0,0,6,1,5,5,0,1,0,0,0,1,100000,1,0,1.0,closed,1
1,1,1,22,3,2,7,5,15,1,7,7,4,11000000,1,1,1.6667,acquired,1
0,0,0,15,2,1,2,1,13,1,1,1,3,675000,0,1,1.5,acquired,0
1,1,1,20,2,0,2,2,18,0,0,0,5,13000000,0,0,2.5,acquired,1
0,0,0,14,1,1,1,0,13,2,1,2,5,3500000,0,0,2.0,acquired,1
0,0,0,9,1,5,5,0,4,1,0,0,2,12000000,0,0,4.0,closed,1
1,1,1,18,5,1,5,4,13,4,1,5,10,78573646,0,0,4.3333,acquired,1
0,0,0,18,3,0,6,6,12,1,4,4,2,15286415,0,0,1.0,acquired,0
1,1,1,17,1,1,1,0,16,3,2,3,5,3200000,0,0,1.0,acquired,1
2,2,2,1,1,0,0,0,1,1,0,0,1,30000,0,1,2.0,closed,0
1,1,1,23,3,0,11,11,12,1,10,10,28,14650003,0,1,1.0,acquired,0
1,1,1,22,2,3,6,3,16,1,9,9,9,23500000,1,0,5.0,acquired,1
0,0,0,9,1,5,5,0,4,0,0,0,2,980000,0,0,1.0,closed,0
1,1,1,6,1,3,3,0,3,0,0,0,0,20000000,0,0,3.0,closed,1
2,2,2,7,1,-1,-1,0,8,0,0,0,4,1500000,0,0,3.0,closed,0
1,1,1,21,2,4,6,2,15,1,6,6,0,8000000,0,0,1.5,acquired,1
1,1,1,19,4,0,5,5,14,3,3,5,13,25200000,0,0,4.0,acquired,1
1,1,1,21,4,3,5,2,16,2,8,9,21,61000000,0,0,3.0,acquired,1
1,1,1,18,4,1,4,3,14,4,2,6,12,46300000,1,0,4.25,acquired,1
0,0,0,23,4,4,8,4,15,5,6,11,15,24500000,0,0,4.3333,acquired,1
1,1,1,2,2,1,2,1,0,1,-1,-1,1,7500000,0,0,1.0,closed,0
1,1,1,22,1,3,3,0,19,3,4,8,19,14500000,0,0,9.0,acquired,1
2,2,2,5,1,3,3,0,2,1,1,1,1,29000000,1,0,5.0,closed,1
1,1,1,20,3,0,3,3,17,1,6,6,5,24000000,0,0,2.6667,acquired,1
1,1,1,25,4,5,10,5,15,1,8,8,2,81017493,1,0,5.6667,acquired,1
0,0,0,17,2,2,2,0,15,3,2,5,4,1000000,0,1,4.5,acquired,1
0,0,0,15,2,1,2,1,13,2,3,3,14,12010000,1,0,2.5,acquired,1
0,0,0,23,1,4,4,0,19,3,-1,9,2,22000000,0,0,4.0,acquired,1
1,1,1,2,1,8,8,0,-6,0,0,0,1,42700000,0,0,3.0,closed,1
1,1,1,25,3,6,7,1,18,1,4,4,5,80000000,1,0,4.0,acquired,1
1,1,1,14,1,1,1,0,13,3,0,3,3,205000,0,1,7.0,acquired,1
0,0,0,16,1,2,2,0,14,2,0,3,5,3750000,0,0,1.0,acquired,1
1,1,1,2,2,0,1,1,1,2,2,3,11,41000000,0,0,1.5,closed,1
1,1,1,16,2,2,2,0,14,3,2,5,37,76000000,0,0,4.0,acquired,1
0,0,0,19,2,0,3,3,16,2,3,5,9,20000000,0,0,1.0,acquired,1
1,1,1,15,2,1,4,3,11,4,1,4,11,9356180,0,0,1.5,acquired,1
0,0,0,-4,1,-9,-9,0,5,2,-6,-4,6,100000,0,1,1.0,closed,0
0,0,0,18,2,2,5,3,13,2,5,5,9,13600000,0,0,3.0,acquired,1
1,1,1,4,1,1,1,0,3,4,2,4,19,3000000,0,0,2.0,acquired,1
1,1,1,7,5,2,6,4,1,0,0,0,4,21138876,1,0,2.0,closed,1
0,0,0,15,4,0,1,1,14,3,1,2,13,2345000,0,1,5.75,acquired,1
1,1,1,4,1,1,1,0,3,4,2,3,7,4000000,0,0,1.0,closed,0
1,1,1,5,2,4,5,1,0,2,2,4,2,17000000,1,0,3.0,closed,1
0,0,0,16,1,2,2,0,14,1,2,2,8,1100000,0,1,8.0,acquired,1
0,0,0,14,4,0,1,1,13,1,1,1,3,59700,0,1,1.0,acquired,1
1,1,1,16,1,0,0,0,16,3,3,4,12,2350000,0,0,2.0,acquired,1
0,0,0,4,1,2,2,0,2,1,1,1,2,10000000,0,0,2.0,closed,1
1,1,1,2,2,1,1,0,1,1,0,0,2,21189,1,1,1.0,closed,1
0,0,0,21,3,2,5,3,16,2,8,8,7,28000000,0,0,2.6667,acquired,1
1,1,1,9,1,3,3,0,6,0,0,0,0,9500000,1,0,2.0,closed,0
1,1,1,21,3,2,6,4,15,1,2,2,5,69600000,1,0,7.6667,acquired,1
0,0,0,21,3,3,6,3,15,2,3,7,11,23500000,1,0,3.6667,acquired,1
2,2,2,23,1,4,4,0,19,1,7,7,6,13000000,0,0,4.0,acquired,1
0,0,0,20,2,2,3,1,17,2,3,3,8,21750000,1,0,2.0,acquired,1
0,0,0,11,1,5,5,0,6,0,0,0,0,5750000,0,0,4.0,closed,1
0,0,0,20,2,1,1,0,19,1,0,0,1,23400000,0,0,2.5,acquired,1
1,1,1,2,1,1,1,0,1,3,1,4,4,4300000,0,0,2.0,closed,1
0,0,0,19,2,2,5,3,14,1,-1,-1,1,20000000,1,0,2.0,acquired,1
1,1,1,21,2,4,9,5,12,1,5,5,16,51000000,0,0,3.5,acquired,1
0,0,0,25,4,4,10,6,15,1,3,3,2,27101994,1,0,4.6667,acquired,1
1,1,1,24,1,5,5,0,19,1,4,4,6,6480000,0,0,3.0,acquired,1
1,1,1,17,2,0,2,2,15,2,2,4,8,35000000,0,0,2.5,acquired,1
0,0,0,3,3,-4,0,4,3,2,-1,0,5,11300000,1,0,1.0,closed,1
0,0,0,1,1,0,0,0,1,1,0,0,1,19000,0,1,1.0,closed,0
0,0,0,20,6,2,5,3,15,3,6,8,27,78500000,0,0,3.4,acquired,1
0,0,0,1,1,0,0,0,1,0,0,0,4,600000,0,1,2.0,closed,0
0,0,0,25,2,5,7,2,18,1,7,7,3,13000000,0,0,1.5,acquired,1
1,1,1,4,5,0,3,3,1,3,3,4,7,43600000,0,0,3.0,closed,1
1,1,1,16,5,0,3,3,13,3,3,5,38,142000000,0,0,5.2,acquired,1
1,1,1,16,2,2,3,1,13,2,3,4,6,2000000,1,0,1.5,acquired,1
0,0,0,24,3,2,4,2,20,1,6,6,4,26800000,0,0,3.0,acquired,1
1,1,1,7,6,1,6,5,1,1,0,0,2,55900000,1,0,3.2,closed,1
1,1,1,19,2,2,3,1,16,3,3,7,14,11000000,0,0,2.0,acquired,1
1,1,1,16,3,0,2,2,14,1,3,3,19,31500000,0,0,3.3333,acquired,1
0,0,0,15,1,3,3,0,12,2,0,4,4,1500000,1,0,2.0,acquired,0
0,0,0,2,3,0,1,1,1,3,0,1,5,900000,0,1,1.5,closed,1
1,1,1,22,3,1,6,5,16,1,6,6,4,58000000,0,0,5.0,acquired,1
0,0,0,18,4,0,5,5,13,2,1,5,10,29050000,1,0,2.6667,acquired,1
1,1,1,14,2,1,2,1,12,2,2,3,3,250000,0,1,1.5,acquired,1
1,1,1,8,1,4,4,0,4,0,0,0,2,21000000,0,0,4.0,closed,1
0,0,0,25,2,4,7,3,18,0,0,0,25,35000000,1,0,3.5,acquired,1
1,1,1,2,1,0,0,0,2,1,0,0,2,500000,0,1,1.0,closed,0
0,0,0,25,2,6,6,0,19,1,4,4,3,30920000,1,0,3.5,acquired,1
1,1,1,23,4,2,8,6,15,1,7,7,9,29288979,1,0,2.6667,acquired,1
0,0,0,14,4,8,12,4,2,2,12,12,11,24200000,1,0,2.3333,closed,1
1,1,1,18,1,1,1,0,17,3,1,5,4,1000000,0,0,1.0,acquired,0
4,4,4,22,2,1,3,2,19,1,5,5,3,5550000,0,1,1.0,acquired,1
1,1,1,4,2,0,2,2,2,3,0,2,8,3000000,0,1,3.5,closed,1
1,1,1,19,2,1,2,1,17,3,5,7,13,14300000,0,0,4.5,acquired,1
1,1,1,11,1,4,4,0,7,0,0,0,0,1000000,1,0,2.0,closed,0
1,1,1,22,2,3,3,0,19,1,8,8,7,11000000,1,0,1.5,acquired,1
0,0,0,6,2,2,3,1,3,3,2,4,7,2000000,1,1,3.0,closed,0
0,0,0,17,2,1,3,2,14,2,4,5,17,5000000,1,1,1.0,acquired,1
1,1,1,17,1,2,2,0,15,2,4,4,12,11000000,0,0,3.0,acquired,1
1,1,1,16,4,0,3,3,13,4,4,5,19,14100000,0,1,2.25,acquired,1
1,1,1,3,1,0,0,0,3,1,2,2,8,5000000,0,0,1.0,closed,0
2,2,2,3,2,0,2,2,1,1,0,0,1,400000,0,1,1.0,closed,0
1,1,1,25,1,7,7,0,18,1,4,4,4,10000000,0,0,1.0,acquired,0
0,0,0,6,3,1,4,3,2,1,2,2,3,11035000,1,0,1.6667,closed,1
0,0,0,25,1,6,6,0,19,2,8,11,9,12700000,0,0,4.0,acquired,1
0,0,0,17,2,3,4,1,13,1,0,0,3,20757182,0,0,1.0,acquired,1
1,1,1,24,3,5,7,2,17,1,11,11,5,27000000,0,0,6.0,acquired,1
0,0,0,20,1,4,4,0,16,3,6,7,7,10000000,0,0,1.0,acquired,0
1,1,1,8,1,4,4,0,4,0,0,0,4,26000000,0,0,4.0,closed,1
0,0,0,5,2,2,5,3,0,0,0,0,2,4000000,0,0,2.0,closed,1
1,1,1,21,2,2,4,2,17,1,-3,-3,3,20220000,0,0,3.0,acquired,1
0,0,0,23,1,4,4,0,19,3,6,9,7,10000000,0,0,4.0,acquired,1
0,0,0,4,2,2,4,2,0,3,1,4,8,7350000,0,0,4.5,closed,1
1,1,1,4,1,1,1,0,3,1,0,0,1,50000,0,1,1.0,closed,0
0,0,0,4,1,2,2,0,2,3,2,3,5,1000000,0,0,7.0,closed,1
1,1,1,9,4,3,6,3,3,2,8,8,16,45000000,0,0,2.0,closed,1
1,1,1,6,5,0,5,5,1,5,0,6,22,70000000,1,0,4.2,closed,1
2,2,2,4,1,1,1,0,3,2,1,1,3,500000,0,0,1.0,closed,1
1,1,1,2,2,0,1,1,1,0,0,0,6,500000,0,0,1.0,closed,1
0,0,0,21,3,1,4,3,17,1,3,3,2,44000000,0,0,4.0,acquired,1
0,0,0,13,1,10,10,0,3,1,6,6,4,21000000,1,0,5.0,closed,1
1,1,1,16,2,1,1,0,15,2,1,2,12,19000000,0,0,3.5,acquired,1
0,0,0,6,3,1,5,4,1,0,0,0,0,18700000,1,0,2.0,closed,1
1,1,1,15,1,1,1,0,14,2,2,2,6,10000000,0,0,7.0,acquired,1
3,3,3,6,3,0,0,0,6,0,0,0,5,5900000,0,1,1.0,closed,0
1,1,1,21,2,3,4,1,17,2,6,6,13,28000000,0,0,2.0,acquired,1
0,0,0,5,7,0,4,4,1,2,3,4,5,24300000,1,1,2.0,closed,1
1,1,1,20,4,0,5,5,15,3,6,7,21,32006000,0,1,1.6667,acquired,1
1,1,1,23,1,3,3,0,20,1,1,1,4,13400000,0,0,2.0,acquired,1
1,1,1,19,3,4,5,1,14,3,5,7,18,9400000,0,1,1.5,acquired,1
0,0,0,20,6,1,8,7,12,3,3,7,10,15324624,1,1,2.5,acquired,1
2,2,2,15,1,1,1,0,14,2,2,4,3,2000000,0,0,11.0,acquired,1
1,1,1,17,3,0,4,4,13,4,1,5,24,16000000,0,0,5.6667,acquired,1
4,4,4,7,3,4,7,3,0,0,0,0,3,44000000,1,0,2.3333,closed,1
0,0,0,3,2,2,2,0,1,1,1,1,2,1175000,1,0,1.0,closed,0
1,1,1,25,2,7,10,3,15,1,13,13,22,9000000,0,0,4.0,acquired,1
1,1,1,23,3,0,5,5,18,1,9,9,9,35150000,0,0,3.0,acquired,1
0,0,0,20,3,1,6,5,14,2,2,6,4,12000000,1,0,2.6667,acquired,1
1,1,1,23,1,6,6,0,17,1,5,5,4,30000000,0,0,9.0,acquired,1
1,1,1,22,1,6,6,0,16,1,7,7,5,8000000,0,0,2.0,acquired,1
1,1,1,18,1,2,2,0,16,3,2,3,6,4100000,0,0,2.0,acquired,1
0,0,0,5,2,2,4,2,1,1,3,3,1,2408500,0,1,3.0,closed,1
1,1,1,9,4,2,6,4,3,1,6,6,3,72000000,0,0,2.25,closed,1
4,4,4,6,2,1,2,1,4,1,3,3,2,18400000,1,0,1.0,closed,0
0,0,0,15,7,8,15,7,0,1,4,4,4,162264126,1,0,6.75,closed,1
0,0,0,22,1,7,7,0,15,1,6,6,7,29000000,1,0,7.0,acquired,1
2,2,2,7,1,5,5,0,2,0,0,0,0,8700000,0,0,2.0,closed,1
0,0,0,24,1,5,5,0,19,2,4,9,12,10000000,0,0,7.0,acquired,1
0,0,0,17,2,1,3,2,14,2,3,4,5,15000000,0,0,2.0,acquired,1
0,0,0,1,1,1,1,0,0,1,0,0,2,2600000,0,0,1.0,closed,0
1,1,1,19,1,1,1,0,18,3,6,9,30,15000000,0,0,1.0,acquired,1
0,0,0,13,3,0,2,2,11,2,1,2,7,4000000,0,1,2.0,acquired,1
1,1,1,19,2,1,6,5,13,1,5,5,9,73000000,1,0,3.0,acquired,1
0,0,0,13,4,0,1,1,12,3,1,2,5,12123837,0,1,4.6667,acquired,1
2,2,2,19,3,1,2,1,17,3,3,5,18,22400000,1,0,3.3333,acquired,1
1,1,1,16,2,1,2,1,14,3,2,3,12,5700000,0,0,4.0,acquired,1
0,0,0,8,2,5,8,3,0,0,0,0,2,28500000,1,0,4.5,closed,1
0,0,0,18,2,1,2,1,16,1,2,2,9,21000000,0,0,2.5,acquired,1
0,0,0,28,1,22,22,0,6,1,25,25,1,8000000,1,0,2.0,closed,0
1,1,1,2,1,0,0,0,2,1,0,0,1,1500000,0,0,1.0,closed,1
0,0,0,18,3,1,2,1,16,4,3,5,17,28300000,0,0,1.6667,acquired,1
1,1,1,17,5,2,5,3,12,2,2,3,4,7939553,1,0,2.0,acquired,1
1,1,1,3,1,1,1,0,2,0,0,0,3,545000,0,1,2.0,closed,1
0,0,0,24,3,5,9,4,15,1,5,5,10,15247925,0,0,1.5,acquired,1
0,0,0,18,3,0,3,3,15,2,2,5,11,12800000,0,1,1.5,acquired,1
0,0,0,3,2,1,2,1,1,2,0,1,1,950000,1,0,3.0,closed,1
0,0,0,25,2,3,5,2,20,5,2,13,6,16000000,0,0,1.0,acquired,1
1,1,1,25,1,6,6,0,19,1,6,6,2,10000000,0,0,1.0,acquired,1
0,0,0,14,1,1,1,0,13,3,0,2,5,1500000,0,0,1.0,acquired,0
1,1,1,7,2,6,7,1,0,2,6,6,6,13000000,1,0,2.0,closed,1
0,0,0,16,1,3,3,0,13,2,4,5,6,10000000,1,0,6.0,acquired,1
0,0,0,17,2,2,3,1,14,2,2,4,9,3915000,1,0,3.0,acquired,1
0,0,0,15,2,0,2,2,13,2,2,3,7,1400000,0,1,6.0,acquired,1
0,0,0,0,2,0,1,1,-1,2,0,1,6,650000,1,1,1.0,closed,1
0,0,0,3,3,0,3,3,0,4,0,7,5,9700000,1,0,1.0,closed,1
1,1,1,22,1,3,3,0,19,1,2,2,6,15000000,0,0,3.0,acquired,1
1,1,1,23,4,4,10,6,13,3,10,11,18,38764000,1,0,2.0,acquired,1
1,1,1,7,8,0,6,6,1,2,1,5,6,211403000,1,0,2.7143,closed,1
1,1,1,17,2,2,3,1,14,3,3,5,8,20750000,0,0,2.0,acquired,1
1,1,1,15,2,1,2,1,13,2,2,3,4,1020000,0,1,2.5,acquired,1
0,0,0,3,1,0,0,0,3,1,2,2,6,13000000,0,0,4.0,closed,1
0,0,0,17,2,0,4,4,13,2,0,3,8,14700000,0,1,4.0,acquired,1
1,1,1,20,4,1,4,3,16,4,3,9,19,33000000,0,0,1.3333,acquired,1
1,1,1,20,1,5,5,0,15,0,0,0,5,30000000,0,0,6.0,acquired,1
0,0,0,5,4,0,4,4,1,3,2,4,10,33000000,0,0,4.0,closed,1
0,0,0,1,1,-1,-1,0,2,0,0,0,1,150000,0,1,1.0,closed,0
0,0,0,3,1,0,0,0,3,1,1,1,3,20000,0,1,1.0,closed,0
1,1,1,5,3,4,5,1,0,0,0,0,2,30926154,0,0,3.0,closed,1
1,1,1,1,1,1,1,0,0,0,0,0,0,2000000,0,0,1.0,closed,0
0,0,0,10,2,5,9,4,1,1,2,2,2,19000000,1,0,3.5,closed,1
1,1,1,10,3,3,7,4,3,1,4,4,2,33000000,0,0,4.0,closed,1
0,0,0,23,3,4,6,2,17,1,4,4,1,15650000,1,0,1.3333,acquired,1
1,1,1,24,3,6,8,2,16,3,7,11,8,17400000,0,0,2.3333,acquired,1
1,1,1,2,1,1,1,0,1,2,0,1,5,154000,0,1,1.0,closed,0
1,1,1,7,1,5,5,0,2,2,7,7,4,35000000,0,0,3.0,closed,1
0,0,0,5,4,1,4,3,1,3,1,2,5,7516703,1,1,1.0,closed,0
0,0,0,3,1,3,3,0,0,3,3,4,1,48000000,1,0,5.0,closed,1
1,1,1,25,3,5,8,3,17,1,8,8,6,65800000,1,0,4.6667,acquired,1
0,0,0,1,2,1,1,0,0,1,0,0,2,125000,0,1,1.0,closed,0
0,0,0,18,1,1,1,0,17,3,-1,4,5,750000,0,1,2.0,acquired,1
0,0,0,16,1,2,2,0,14,2,2,2,10,17000000,1,0,5.0,acquired,1
1,1,1,13,3,10,13,3,0,3,9,13,4,4087500,1,1,1.0,closed,0
1,1,1,17,1,11,11,0,6,1,15,15,3,1000000,0,0,2.0,closed,1
0,0,0,17,5,0,6,6,11,3,5,7,13,23500000,1,0,1.75,acquired,1
1,1,1,4,1,0,0,0,4,0,0,0,2,990000,0,0,2.0,closed,0
1,1,1,17,1,1,1,0,16,2,3,5,13,1000000,0,0,3.0,acquired,1
0,0,0,19,4,1,5,4,14,2,3,6,15,41000000,1,0,1.75,acquired,1
2,2,2,3,1,0,0,0,3,0,0,0,3,7000000,0,0,1.0,closed,1
0,0,0,17,2,1,2,1,15,1,1,1,4,55000000,0,0,2.0,acquired,1
1,1,1,17,2,4,5,1,12,2,5,5,10,69000000,0,0,3.5,acquired,1
1,1,1,19,8,1,7,6,12,3,5,7,25,129677153,1,0,3.0,acquired,1
1,1,1,19,6,3,7,4,12,0,0,0,4,232000100,0,0,3.6667,acquired,1
1,1,1,15,2,0,2,2,13,3,2,4,5,5700000,0,1,4.0,acquired,1
0,0,0,23,1,6,6,0,17,1,4,4,3,10500000,0,0,4.0,acquired,1
0,0,0,7,2,2,4,2,3,0,0,0,2,23000000,1,0,3.0,closed,1
2,2,2,24,3,5,9,4,15,0,0,0,13,14000000,0,0,3.0,acquired,1
1,1,1,20,2,2,2,0,18,0,0,0,4,7500000,0,1,2.0,acquired,1
0,0,0,16,1,1,1,0,15,3,0,2,12,1420000,0,0,16.0,acquired,1
2,2,2,2,2,0,2,2,0,2,0,2,1,9000000,1,0,1.0,closed,1
0,0,0,3,1,1,1,0,2,0,0,0,3,500000,1,0,1.0,closed,1
1,1,1,12,2,0,1,1,11,2,0,1,4,70000,0,1,1.0,acquired,1
1,1,1,3,2,1,2,1,1,0,0,0,3,850000,0,1,1.0,closed,1
1,1,1,17,1,4,4,0,13,2,3,6,9,15000000,1,0,1.0,acquired,1
1,1,1,17,2,1,1,0,16,2,0,2,12,3150000,0,1,11.5,acquired,1
1,1,1,2,1,1,1,0,1,2,1,3,6,5500000,0,0,8.0,closed,1
1,1,1,16,1,5,5,0,11,1,3,3,8,10571182,0,0,1.0,acquired,0
1,1,1,2,1,1,1,0,1,0,0,0,13,500000,0,1,1.0,closed,0
1,1,1,19,7,1,5,4,14,3,1,8,12,24900000,1,1,3.0,acquired,1
1,1,1,4,2,2,2,0,2,3,1,3,12,3529175,1,0,1.0,closed,0
0,0,0,16,4,0,5,5,11,3,3,5,15,23400000,0,0,2.25,acquired,1
1,1,1,23,1,7,7,0,16,3,7,12,15,8800000,0,0,5.0,acquired,1
0,0,0,1,1,0,0,0,1,1,0,0,2,1500000,0,0,6.0,closed,1
1,1,1,11,7,5,9,4,2,0,0,0,3,74000000,1,0,2.0,closed,1
2,2,2,25,3,1,2,1,23,2,7,11,3,8800000,0,0,1.0,acquired,0
1,1,1,24,2,3,5,2,19,3,1,10,3,7100000,0,1,1.5,acquired,1
0,0,0,18,3,1,3,2,15,6,2,6,8,3500000,1,1,1.6667,acquired,1
1,1,1,15,1,2,2,0,13,2,1,3,6,3000000,0,0,2.0,acquired,1
0,0,0,0,2,0,0,0,0,1,0,0,5,11000,0,1,1.0,closed,0
1,1,1,24,3,7,9,2,15,1,5,5,4,26200000,1,0,2.5,acquired,1
1,1,1,6,2,1,3,2,3,3,4,6,6,29000000,0,0,2.5,acquired,1
1,1,1,8,1,5,5,0,3,0,0,0,2,10000000,0,0,2.0,closed,0
1,1,1,1,1,1,1,0,0,3,0,3,3,500000,0,1,3.0,closed,1
1,1,1,17,3,0,2,2,15,3,1,2,3,11500000,0,1,1.5,acquired,1
0,0,0,15,5,1,4,3,11,3,2,3,8,5350000,0,1,3.0,acquired,1
1,1,1,7,3,1,4,3,3,4,5,7,27,11015719,1,0,2.0,closed,1
1,1,1,15,3,1,1,0,14,3,1,3,30,9807367,0,1,8.6667,acquired,1
1,1,1,14,2,0,1,1,13,2,1,3,8,2535000,0,1,5.0,acquired,1
0,0,0,23,3,5,9,4,14,2,9,9,4,19000000,1,0,5.3333,acquired,1
1,1,1,14,3,0,3,3,11,1,1,1,4,475000,0,1,4.0,acquired,0
0,0,0,22,2,6,8,2,14,1,9,9,16,36000000,1,0,1.0,acquired,1
1,1,1,23,1,3,3,0,20,0,0,0,4,12000000,0,0,5.0,acquired,1
0,0,0,16,4,0,4,4,12,1,3,3,15,122000000,0,0,2.5,acquired,1
0,0,0,12,1,0,0,0,12,2,1,1,8,1750000,0,0,5.0,acquired,1
0,0,0,15,1,1,1,0,14,2,0,2,3,130000,0,1,1.0,acquired,0
0,0,0,13,3,8,11,3,2,0,0,0,4,13222860,1,0,3.0,closed,1
0,0,0,7,2,4,6,2,1,3,6,6,10,2192000,1,0,3.0,closed,0
0,0,0,20,1,5,5,0,15,1,2,2,4,2000000,1,0,1.0,acquired,1
1,1,1,20,2,3,5,2,15,2,7,7,11,9400000,0,0,2.0,acquired,1
1,1,1,22,4,5,7,2,15,0,0,0,2,13045000,0,0,2.0,acquired,1
-1,-1,-1,19,4,0,4,4,15,3,1,5,8,10000000,0,0,1.25,acquired,1
1,1,1,18,1,1,1,0,17,1,1,1,7,6000000,0,0,2.0,acquired,1
0,0,0,7,2,2,4,2,3,1,5,5,3,2100000,1,1,2.0,closed,0
0,0,0,15,2,0,1,1,14,3,0,2,3,3250000,1,0,1.0,acquired,1
1,1,1,12,3,7,7,0,5,0,0,0,1,148000000,1,0,3.5,closed,1
1,1,1,25,2,4,9,5,16,1,11,11,10,24500000,1,0,2.0,acquired,1
0,0,0,2,2,0,1,1,1,1,1,1,4,72000,0,1,1.0,closed,0
1,1,1,7,1,7,7,0,0,1,4,4,3,10360000,0,0,5.0,closed,1
0,0,0,16,3,0,2,2,14,2,2,5,12,1310000,0,1,6.0,acquired,1
0,0,0,2,1,0,0,0,2,1,0,0,1,150000,0,1,1.0,closed,0
1,1,1,22,3,3,9,6,13,2,0,10,5,64000000,1,0,3.3333,acquired,1
0,0,0,2,1,0,0,0,2,1,0,0,2,250000,0,1,1.0,closed,0
1,1,1,17,3,0,2,2,15,1,1,1,6,1830000,0,1,2.0,acquired,0
0,0,0,14,2,0,1,1,13,4,1,2,10,9800000,0,0,4.5,acquired,1
0,0,0,19,1,2,2,0,17,3,4,6,15,2300000,0,0,1.0,acquired,0
2,2,2,4,2,2,3,1,1,4,0,4,3,1310000,0,1,1.0,closed,0
1,1,1,3,2,0,1,1,2,5,0,4,4,4500000,0,1,5.5,closed,1
1,1,1,22,3,2,6,4,16,1,5,5,5,22000000,0,0,2.6667,acquired,1
1,1,1,18,3,1,2,1,16,3,3,4,23,10000000,0,1,2.6667,acquired,1
0,0,0,15,4,1,2,1,13,3,3,3,21,36500000,0,0,1.5,acquired,1
2,2,2,21,7,2,10,8,11,3,9,10,35,33672656,1,0,2.0,acquired,1
1,1,1,16,3,1,3,2,13,1,3,3,4,19000000,0,0,2.0,acquired,1
1,1,1,23,1,3,3,0,20,1,2,2,3,30000000,0,0,4.0,acquired,1
1,1,1,15,2,2,3,1,12,2,3,4,6,2250000,1,0,8.5,acquired,1
1,1,1,25,6,6,10,4,15,1,8,8,7,53818873,1,0,4.25,acquired,1
1,1,1,4,1,3,3,0,1,0,0,0,6,5500000,0,0,1.0,closed,1
2,2,2,18,1,2,2,0,16,2,0,4,3,6000000,0,0,1.0,acquired,1
0,0,0,3,2,1,2,1,1,3,0,8,2,30150000,0,0,1.5,closed,1
1,1,1,23,2,4,6,2,17,0,0,0,11,83000000,1,0,1.0,acquired,0
0,0,0,6,2,1,3,2,3,0,0,0,1,12000000,0,0,1.0,closed,0
1,1,1,17,2,0,1,1,16,2,3,6,6,3500000,0,1,1.0,acquired,0
1,1,1,19,1,1,1,0,18,3,2,3,5,4000000,0,0,4.0,acquired,1
1,1,1,4,2,2,4,2,0,0,0,0,9,4000000,0,0,1.0,closed,1
1,1,1,25,2,6,8,2,17,1,10,10,11,25000000,1,0,4.5,acquired,1
0,0,0,17,3,1,4,3,13,1,1,1,5,1420698,1,1,2.0,acquired,1
1,1,1,23,2,2,5,3,18,1,-4,-4,5,10000000,1,0,3.0,acquired,1
1,1,1,18,3,1,5,4,13,5,2,7,18,67000000,0,0,2.6667,acquired,1
1,1,1,19,4,0,5,5,14,3,4,6,13,53000000,0,1,4.5,acquired,1
1,1,1,2,2,0,1,1,1,2,0,1,5,300000,0,1,2.0,closed,1
1,1,1,23,3,6,9,3,14,2,7,8,4,1400000,0,1,1.0,acquired,0
1,1,1,21,2,3,4,1,17,3,2,7,4,6500000,0,0,7.0,acquired,1
1,1,1,16,1,1,1,0,15,3,3,4,8,5000000,0,0,1.0,acquired,1
0,0,0,18,2,3,6,3,12,2,4,6,6,9600000,0,0,3.0,acquired,1
2,2,2,24,5,0,7,7,17,3,4,11,9,58200000,0,0,1.4,acquired,1
0,0,0,19,3,1,4,3,15,2,1,5,14,28000000,0,0,2.6667,acquired,1
0,0,0,20,2,5,5,0,15,3,6,8,10,30000000,1,0,1.0,acquired,0
1,1,1,18,2,1,2,1,16,2,4,5,10,3500000,0,1,2.0,acquired,0
0,0,0,4,1,0,0,0,4,2,-1,0,7,16700000,0,0,4.0,closed,0
1,1,1,16,1,11,11,0,5,0,0,0,0,18000000,0,0,7.0,closed,1
1,1,1,22,1,8,8,0,14,1,7,7,6,15000000,0,0,6.0,acquired,1
1,1,1,8,2,4,4,0,4,0,0,0,2,12000000,0,0,4.0,closed,1
0,0,0,3,1,1,1,0,2,1,0,0,1,15000,0,1,1.0,closed,0
2,2,2,15,1,1,1,0,14,3,1,3,11,200000,1,0,1.0,acquired,0
1,1,1,9,1,4,4,0,5,0,0,0,0,15000000,0,0,1.0,closed,0
1,1,1,15,2,0,1,1,14,2,0,1,4,1400000,0,1,3.0,acquired,0
0,0,0,7,4,-1,6,7,1,1,5,5,5,11400000,1,0,3.0,closed,1
0,0,0,17,4,0,3,3,14,4,1,6,4,3800000,0,1,4.75,acquired,1
1,1,1,22,2,4,6,2,16,1,7,7,3,10100000,1,0,3.0,acquired,1
1,1,1,9,1,4,4,0,5,0,0,0,0,4000000,0,0,6.0,closed,1
1,1,1,17,1,2,2,0,15,3,2,2,11,3011408,0,0,1.0,acquired,1
1,1,1,10,1,10,10,0,0,1,6,6,2,8000000,1,0,3.0,closed,1
1,1,1,14,2,0,3,3,11,1,2,2,15,12700000,0,0,1.5,acquired,1
1,1,1,4,1,0,0,0,4,4,0,3,5,300000,0,1,2.0,closed,0
1,1,1,11,1,0,0,0,11,2,-2,0,21,5675000,1,0,4.0,acquired,1
1,1,1,16,1,4,4,0,12,2,5,5,13,1000000,0,1,5.0,acquired,1
3,3,3,4,1,0,0,0,4,0,0,0,2,125000,0,1,1.0,closed,0
0,0,0,3,2,0,1,1,2,2,1,1,2,700000,0,1,2.5,closed,0
2,2,2,14,2,0,1,1,13,2,1,2,6,532000,0,1,5.0,acquired,1
1,1,1,19,2,0,2,2,17,3,5,6,8,8500000,0,0,1.0,acquired,1
2,2,2,22,1,4,4,0,18,3,6,9,2,9400000,0,0,1.0,acquired,1
0,0,0,2,2,-1,2,3,0,1,2,2,3,350000,0,1,1.0,closed,1
0,0,0,18,2,1,3,2,15,3,1,3,16,12300000,0,0,1.5,acquired,1
0,0,0,19,5,2,6,4,13,1,4,4,6,25413298,1,0,3.0,acquired,1
1,1,1,14,2,0,1,1,13,2,3,4,23,9800000,0,1,4.5,acquired,1
1,1,1,3,2,0,0,0,3,2,0,1,5,1015000,0,1,5.0,closed,1
0,0,0,16,5,0,3,3,13,2,0,2,4,10000003,1,0,1.5,acquired,1
0,0,0,17,2,1,3,2,14,2,0,3,3,1750000,1,1,1.0,acquired,1
1,1,1,15,1,1,1,0,14,2,1,4,4,100000,0,1,3.0,acquired,1
1,1,1,14,1,2,2,0,12,2,2,2,1,12000000,1,0,2.0,acquired,1
0,0,0,14,2,0,1,1,13,3,1,3,16,11450000,0,1,8.5,acquired,1
1,1,1,4,1,1,1,0,3,2,-1,1,7,50000,0,1,3.0,closed,0
1,1,1,4,1,3,3,0,1,2,3,5,4,20000000,0,0,4.0,closed,1
0,0,0,22,2,3,4,1,18,3,7,8,16,42500000,0,0,5.5,acquired,1
1,1,1,19,3,0,2,2,17,2,0,5,7,22487000,1,0,2.3333,acquired,1
1,1,1,18,1,3,3,0,15,2,-1,4,3,7800000,1,0,2.0,acquired,1
0,0,0,24,4,4,10,6,14,1,3,3,8,59000000,0,0,6.0,acquired,1
-1,-1,-1,4,1,2,2,0,2,4,1,2,5,4000000,0,0,1.0,closed,1
1,1,1,16,4,2,5,3,11,3,2,5,6,71400000,1,0,2.6667,acquired,1
1,1,1,17,3,1,4,3,13,1,4,4,5,25500000,0,0,2.6667,acquired,1
0,0,0,20,4,6,8,2,12,3,6,8,28,28932322,1,0,2.6667,acquired,1
1,1,1,17,6,1,6,5,11,3,6,7,18,35200000,1,0,2.3333,acquired,1
0,0,0,12,2,5,8,3,4,1,8,8,2,10000000,1,0,2.5,closed,1
1,1,1,16,3,1,4,3,12,4,1,4,11,22100000,1,0,2.6667,acquired,1
0,0,0,24,5,3,9,6,15,1,1,1,4,33000000,1,0,2.0,acquired,1
1,1,1,24,1,6,6,0,18,1,6,6,9,15000000,0,0,3.0,acquired,1
1,1,1,25,3,7,9,2,16,1,6,6,6,13000000,0,0,3.0,acquired,1
1,1,1,21,2,2,3,1,18,1,2,2,5,12800000,0,0,2.5,acquired,1
0,0,0,5,2,0,4,4,1,3,4,6,6,626096,1,0,1.0,closed,1
0,0,0,16,4,0,4,4,12,3,4,5,12,20350000,0,1,3.75,acquired,1
1,1,1,8,1,6,6,0,2,1,2,2,1,10000000,1,0,3.0,closed,1
1,1,1,14,1,1,1,0,13,3,1,2,5,425000,0,1,2.0,acquired,1
1,1,1,22,3,5,8,3,14,1,5,5,5,37891054,1,0,3.0,acquired,1
1,1,1,21,5,1,8,7,13,1,7,7,9,40000000,1,0,4.0,acquired,1
1,1,1,17,3,1,2,1,15,4,2,4,10,5550000,0,0,3.0,acquired,1
1,1,1,15,1,1,1,0,14,3,0,2,3,770000,0,1,6.0,acquired,1
0,0,0,5,4,0,5,5,0,0,0,0,0,19550000,1,0,1.0,closed,1
0,0,0,17,2,1,2,1,15,1,2,2,6,4000000,1,0,1.0,acquired,0
0,0,0,20,4,1,6,5,14,4,6,9,14,42000000,0,0,2.3333,acquired,1
0,0,0,5,1,4,4,0,1,0,0,0,0,1900000,0,0,1.0,closed,1
1,1,1,16,3,1,3,2,13,3,3,4,21,45039999,0,0,3.6667,acquired,1
1,1,1,7,1,5,5,0,2,1,6,6,1,1310000,1,0,4.0,closed,1
2,2,2,24,1,7,7,0,17,1,8,8,3,3000000,0,0,3.0,acquired,0
1,1,1,17,4,0,3,3,14,3,2,4,9,36000000,0,0,3.0,acquired,1
1,1,1,14,1,0,0,0,14,1,1,1,3,3000000,1,0,1.0,acquired,0
1,1,1,1,1,1,1,0,0,3,1,5,1,1300000,0,1,8.0,closed,1
0,0,0,15,1,10,10,0,5,1,10,10,1,50000,1,0,1.0,closed,0
0,0,0,18,1,6,6,0,12,3,6,7,15,6500000,0,0,8.0,acquired,1
0,0,0,14,2,1,1,0,13,2,0,3,5,4600000,0,1,9.0,acquired,1
0,0,0,20,3,2,6,4,14,2,2,7,5,21900000,1,0,1.6667,acquired,1
0,0,0,16,1,0,0,0,16,1,1,1,6,240000,0,1,2.0,acquired,1
1,1,1,20,4,0,5,5,15,1,5,5,17,34700000,1,0,2.25,acquired,1
0,0,0,20,4,1,6,5,14,2,4,7,4,33000000,1,0,5.3333,acquired,1
0,0,0,3,2,1,2,1,1,2,0,2,3,1800000,1,1,5.0,closed,1
0,0,0,19,3,0,4,4,15,4,3,5,14,27300000,0,0,3.0,acquired,1
1,1,1,5,2,3,5,2,0,2,3,4,6,6760000,1,0,1.5,closed,1
1,1,1,25,3,0,6,6,19,3,0,10,24,26914000,0,0,6.0,acquired,1
1,1,1,23,1,4,4,0,19,0,0,0,1,27500000,0,0,7.0,acquired,1
0,0,0,6,1,4,4,0,2,0,0,0,4,9000000,0,0,2.0,closed,1
1,1,1,5,1,4,4,0,1,1,-7,-7,3,954000,1,0,1.0,closed,0
-1,-1,-1,25,3,5,9,4,16,0,0,0,4,53000000,0,0,4.6667,acquired,1
1,1,1,21,4,2,7,5,14,3,7,9,17,23100000,1,0,2.0,acquired,1
1,1,1,19,4,1,6,5,13,2,7,7,28,108900000,0,0,7.5,acquired,1
1,1,1,20,4,1,4,3,16,5,3,8,26,55000000,0,0,2.75,acquired,1
0,0,0,15,2,1,3,2,12,3,2,5,9,5686383,0,0,2.0,acquired,0
1,1,1,9,6,4,8,4,1,1,7,7,4,49008830,1,0,3.0,closed,1
1,1,1,19,3,2,4,2,15,0,0,0,10,32200000,0,0,4.0,acquired,1
0,0,0,4,1,1,1,0,3,1,7,7,3,2000000,0,0,1.0,closed,0
0,0,0,18,1,3,3,0,15,2,3,5,5,2700000,0,0,2.0,acquired,1
0,0,0,8,1,5,5,0,3,2,3,9,6,2000000,0,0,2.0,closed,0
0,0,0,18,3,0,4,4,14,3,3,6,16,18000000,1,0,2.3333,acquired,1
2,2,2,25,5,6,9,3,16,2,9,9,9,122500000,1,0,5.6,acquired,1
1,1,1,16,1,1,1,0,15,2,1,5,9,1100000,0,0,6.0,acquired,1
0,0,0,10,3,7,9,2,1,1,6,6,1,52000000,1,0,2.6667,closed,1
1,1,1,13,1,8,8,0,5,1,9,9,5,44000000,0,0,8.0,closed,1
1,1,1,16,2,1,3,2,13,2,1,4,12,15500000,0,0,1.0,acquired,1
1,1,1,22,1,3,3,0,19,1,4,4,4,20000000,0,0,3.0,acquired,1
